111111111111111111111111
1                      1
1                      1
1  1  1 1  11          1
1  1  1 1   1          1
1  1111 11  1          1
1           1          1
1           1          1
1  1111111111          1
1  1                   1
1  1                   1
1     222223    6      1
1          2           1
1       4  2           1
1          2    5      1
1          2           1
1                      1
1                      1
1                      1
1              22      1
1    1234567   22      1
1                      1
1                      1
111111111111111111111111
