111111111111111111111111
1                      1
1                      1
1                      1
1                      1
1                      1
1                      1
1                      1
1                      1
1                      1
1                      1
1          c    a      1
1                      1
1       d              1
1               9      1
1                      1
1                      1
1                      1
1                      1
1              22      1
1    2         22      1
1                      1
1                      1
111111111111111111111111
